Camp Area:
########
#Camp..#
#......#
#......#
########


Area:
################
#..............#
#.*............#
#..............#
#..............#
#..............#
################

Path:

xxxx

x
x
x
x